R 1024 768

NO ./tex/11.xpm
WE ./tex/ice.xpm
EA ./tex/ice.xpm
SO ./tex/11.xpm

S  ./tex/coral_sprite.xpm

C 172, 200, 245
F 0, 78, 122


11111111111111111111111111111
10000000001100000000000000001
10110000011100000000000010001
10010000000000000000000010001
10110000011100000000000010001
10000000001100000111011110001
11110111111111000100000010001
11110111111111011101010010001
11000000110101011100000010001
10000000000000001100000010001
10000000000000001102010020001
11000000110101000000000000001
11110111110101000000202000001 
10000000001100000100000010001
10000000000000002000200001001
1000000000100001000000N001001
10000000001101000000000000001
10000000000100000001010000001
11111111111111111111111111111
